---#-----
----#----
---#-----
#---#----
-----#---
---#-----
#-------#
-----#---
---------