---------
-#-#--#--
---------
-------#-
---#----#
#--------
--#---#--
-----#---
---------