##-------
-----#---
#--------
-------#-
-----#---
----#--#-
#---#----
---------
---------