-------#-
-----#-#-
---------
--#------
-----#---
--##-----
-###-----
---------
---------