----------------
#---#--------#--
------#---------
----------------
----------#-----
----------------
---------#------
----------------
----------------
--#---#---------
-------#---#----
-##-------------
-------#--------
----------------
------------#---
----#-----------