----#-----------
--#-------------
----------------
----------#-----
----------------
#-----------#---
-#----#---#-----
----------------
----------------
-------#--------
------#---------
------#---------
--#-----#-------
-------------#--
------------#---
----------------