----------------
---#------------
-------#--------
----------------
#---#-----------
---------#------
-#------#-------
----------------
----#--#--------
-------#------#-
----------------
----------------
----------------
----------------
--------#-#-----
#---------#-----