----------------
-------#--------
#---#-----------
-------#--#--#--
-#-----#--------
----------------
----------------
------------#---
------------#---
---#------------
----------------
---------#------
---#------------
--------------#-
----------------
-#--------------